####################
#.....P....B.B...r.#
#.....P.........SS.#
#.....P.........SS.#
#######............#
#..........P.......#
#.s................#
#.B..........r.P....
#.......Ps..Pr......
#.B..........r.....#
#......P..P..P.....#
#.............r....#
#rSS............SS.#
#rSS............SS.#
#.....B.....B....c.#
#########RR#########
E
I