####################
#.............#....#
#.S...........#.T..#
#.............#....#
#.S...........#SLSS#
#.............#....#
#.S...........#B..B#
..............#....#
..............#.....
#.S...........######
#...h........b...b.#
#.S.............b..#
#....BB......b..b.B#
#.S..BB.......B..b.#
#..........B...b...#
####################
E
I