####################
#ssssssss...B.B.B.B#
#..................#
#...........B.B.B.B#
#..................#
#..................#
#......rr..........#
#..................#
L.........rrr......#
#..................#
#....rr............#
#..................#
#.##............##.#
#.##.......rrr..##.#
#..................#
########S..S########
E
I