#########..#########
#...............PPP#
#c##SSRSSRSRRSRR##P#
#.##SRRRSRSRSSRS##P#
#..S............PPP#
#..S..........######
#B.P..........#....#
#..P.r...r....#.a...
#B.S..........#.....
#..Sr....s....#.BB.#
#.B...........######
#....r...r......B..#
#.##............##.#
#.##............##.#
#B............B...B#
#########..#########
E
I