####################
#.x...P.....r..#....
#PPP.PPP.PPPP.P#.p.#
#.........P....#...#
#P.PPPPPPPPPP.P#####
#.........P.r......#
#PPPPPPP.PPPPPPPP.P#
....r.....P.......r#
.......r..Pr.......#
#PPPPPPPPPPPPPPPP.P#
#.........P........#
#P.PPPPP.PPP.PPPPPP#
#.....P............#
#.....PPPPPPPPP.PPP#
#.BBB.P............#
#########..#########
E
I