########S..S########
R..................#
#...............BB.#
#.......S..S....BB.#
#..................#
#..s...............#
#.......S..S.......#
#..................#
#..................#
#.......S..S.......#
#..................#
#c................c#
#.......S..S.......#
#..................#
#cccc...S..S...cccc#
########S..S########
E
I