########S..S########
#RRRrRRRRRRRRRRRRRR#
#RRRRRRRRRRRRRRRRRR#
#RRRRRRsRRRRRRRRRsR#
#RRRRRRRRRRRcRRRRRR#
#RRRRRRRRRRRRRRRRRR#
#RRRRRRRcRRRrRRrRRRS
#RRRRRRRRRRRRRRRRRR.
#RRRRRRRRRRRRRRRRRR.
#RRRRRRRRRRRRRRRRRRS
#RSSRRRRRRRRRRRsRRR#
#...SSRRRRRRRRRRRRR#
#....SRRRRRRRRRRRRR#
#BB...SRRRRRRRRRRRR#
#BB...SRRRRRRRRRRRR#
####################
E
I