#########..#########
#.....b....b...b...#
#.##..##....##..##.#
#.##..##....##..##.#
#............b.....#
#..........b...b...#
#R################R#
...................L
...................#
#R################R#
#........BB........#
#........BB........#
#.##..##....##..##.#
#.##..##....##..##.#
#..................#
####################
E
I