#########..#########
#..s...............#
#.SSS......S.......#
#....P.....Ss......#
#......s...S.......#
#.....SSS..........#
#P......P..........#
...P.......S.......#
#..........Ss......#
#......P...S.......#
##R#################
##.#################
##.ss###############
##.a.###############
##...###############
####################
E
I