####################
#..................#
#.SS............SS.#
#.SS.....T......SS.#
#..................#
#.S..............S.#
#.S....ssssss....S.#
#......ssssss......#
#......ssssss......#
#.S....ssssss....S.#
#.S..............S.#
#..................#
#SSSSSSSSLLSSSSSSSS#
#..BB..........BB..#
#..................#
#########..#########
E
I