####################
#bbb...............#
#bSS...........h...#
#bSS...............#
#..................#
#bS................#
#bS....BB...........
#......BB...........
#................b..
#bS............BB.b.
#bS............BB..#
#..................#
#bSS............SSb#
#bSS.SS.S..S.SS.SSb#
#bbb.bb......bb.bbb#
########....########
E
I