####################
#..................#
#.SS.SS.S..S.SS.SS.#
#.SS............SS.#
#.......cBB........#
#...c........c.....#
..........c........#
...................#
........c..........#
..........c...c....#
#.......c..........#
#..................#
#.SS............SS.#
#.SS....RRRR....SS.#
#......RRRRRR......#
#########..#########
E
I