#########..#########
#Pcc.c.....c....ccP#
#P##..##....##..##P#
#P##c.c....cc...##P#
#P................P#
#P......c.cc...c..P#
#P#B...cc...c....#P#
#P#..B........c..#P#
#P...........c....P#
#P..B..cc.........P#
#P##........c...##P#
#P##..##....##..##P#
#...................
#...................
#..................#
#########..#########
E
I