########....########
#PPPPPPPP..PPPPPPPP#
#P##PPPPPPPP##SS##P#
#P##PPPPPPPP##a.##P#
#PPPPPPPPPPPS....SP#
#P#PPPPPPPPP#.BB.#P#
#P#PPPPPPPPP#.BB.#P#
#PPPPPPPPPPPS....LP#
#P##PPPPPPPP##..##P#
#P##PPPPPPPP##SS##P#
#PPPPPPPPPPPPPPPPPP#
#..................#
.......r............
..r........r........
#..................#
####################
E
I