#########..#########
#..................#
#..B.............S.#
#.......S..S.......#
#.B...B.....s...r..#
#...............S..#
#.......S..S.......#
#....s.......r..r..#
#..................#
#r..R...S..S...S...#
#..................#
#..S..R........R...#
........S..S.......#
...................#
#r..S...........r..#
######..############
E
I