#########..#########
#.....r.#.......r..#
#.......#..........#
#..###..#########..#
#...#.r.........r..#
#r.r#.....r........#
#..###PP############
#..r#PPPP#.......c..
#...#PPPP#..r....c..
#..###PP###..#######
#........#.........#
#r...r...#......r..#
#..##############..#
#......r...........#
#.r..........r.....#
####################
E
I