####################
#.........r#..B....#
#.##.......#..x.##.#
#.##....p..#.B..##.#
#....r....r#....b..#
#.r........#B.rB...#
###.##############.#
..#...r...r.r.r....#
..#....r.r..r...r..#
#.################.#
#....r..r.r........#
#.s.s..s......r....#
#.##..##.B..##..##.#
#.##B.##...B##..##.#
#..................#
####################
E
I