######..############
#............#.....#
#............#.....#
#............L..T..#
#............#.....#
#............#.....#
#............#######
#.....BB....########
##....BB....########
###........#########
#####....###########
####################
####################
####################
####################
####################
E
I