####################
#b.b............b.b#
#.SS............SS.#
#.SS............SS.#
#..................#
#.S..............S.#
#.S..............S.#
#..................#
#..................#
#.S.p..........p.S.#
#.S..............S.#
#..................#
#SSSSSSSSLSSSSSSSSS#
#........cc........#
#......cccccc......#
#########..#########
E
I