####################
#.....#s#........A.#
#.###.#s#B#BBBBBBB.#
#.#s#.#s#B#BBBBBBB.#
#.#s#.#s#B#BBBBBB..#
#.#s#.#s#.#SSSSS...#
#.#s#.#s#.#SSSSSS..#
#.#s#.#s#B#BBBBBB..#
#.#s#.#s#B#BBBBBB..#
#.#s#.#s#B#BBBBBB..#
#.#s#.#s#.#..R...RR#
#.#s#.#s#.#.R.R.R..#
#.#s#.#s#.#.R.R..R.#
#.#s#.###.#.R.R...R#
#.#s#.....#..R..RR.#
#.##################
E
I