####################
#..................#
#.h................#
#......BB..........#
#......BB..........#
#..........c.......#
#.............BB...#
#.......c.....BB...#
#..................#
#.....BB.....c.....#
#.....BB...........#
#.......c..........#
#...c........c.....#
#.............BB...#
#.............BB...#
########S..S########
E
I