#########..#########
#..........PPPPPPPP#
#.##.......PPPPP##P#
#.##r......PPPPP##P#
#..........PPPPPPPP#
#.r...PPPPPPPPPPPPP#
#.....PPPPPPPPPPPPP#
#...r.PPP##PPP......
#.....PPP##PPP......
#.r...PPPPPPPP.....#
#.....PPPPPPPP.....#
#.........c........#
#.##...c..c.....##.#
#.##............##.#
#..................#
####################
E
I