#L##################
#.........SS..b.....
SSS...SS..SS......SS
SSS...SS.....b..SSSS
#.SS........SSSRRS.#
#.SSSSSS.SS.SSSS...#
#...SSSR.SSSS......#
.......SS..SS...b...
.......SS...........
#.s................#
#...b....b.SR.b..b.#
#..SS........RS.s..#
#..SR..c....c......#
#...s....cc....s.B.#
#........cccc......#
#########cc#########
E
I