########S..S########
R.........c........#
#..................#
#.......S..S.......#
#.............c....#
#...c..............#
#.......S..S.......#
...................#
.........c...c.....#
#....c..S..S.......#
#..................#
#..................#
#SSSSSSSS..SSSSSSSS#
#BB..............BB#
#BB..............BB#
#########..#########
E
I