####################
#####....RR....#####
###....c.RR......###
##.r..r..RR.....r.##
##......####......##
#...r..######......#
#.....########.r...#
#RRRRR########......
#RRRRR########......
#.....##############
#s.s.s.######.T..###
##......########L###
##........#....d..##
###....Z..L......###
#####.....#....#####
####################
E
I