#########..#########
#..................#
#.##..##....##..##.#
#.##..##....##..##.#
#...................
#...................
####################
sssssssssssssssssss#
sssssssssssssssssss#
#..#################
#...................
#...................
#.##################
#.##..##....##..##x#
#.....bbb..........#
####################
E
I