#########..#########
###.....c.........##
###...............##
###..c............##
..#...............##
..#......c........##
#.##s...c.......####
#.##s..........#####
#.###..........#####
#.####........######
..######....########
..##################
####################
####################
####################
####################
E
I